.......#...,,,,,,
.#.#.#X#.##,,,,,,
.....#....#,,,,,,
.#.#...##.#,,,,,,
.X.##X##..#,,,$,,
##....@..##,,,,,,