...........,,,,,,
.#.#.#X#.##,,,,,,
.....#....#,,,,,,
.#.#...##.#,,,,,,
.X.##X##..#,,,$,,
##....@..X.,,,,,,