.......#...,,,,,,
.#.#.#X#.##,,,,,,
.....#....#,,,,,,
.#.#...##.#,,,,,,
.X.##X##..#,,,,,,
##....@..##,,,,,,