.......#...,,,,,,
.#.#.#.#.##,,,,,,
.....#....#,,,,,,
.#.#...##.#,,,,,,
...##.##..#,,,,,,
##....@..##,,,,,,